genesis=ኦሪት_ዘፍጥረት=ኦ_ዘፍ
exodus=ኦሪት_ዘጸአትኦ=ኦ_ዘጸ
leviticus=ኦሪት_ዘሌዋውያን=ኦ_ዘሌ
numbers=ኦሪት_ዘኍልቍ=ኦ_ዘኁ
deuteronomy=ኦሪት_ዘዳግም=ኦ_ዘዳ
joshua=መጽሐፈ_ኢያሱ_ወልደ_ነዌ=ኢ_ወ_ነ
judges=መጽሐፈ_መሣፍንት=መጽ_መሣ
ruth=መጽሐፈ_ሩት=መፀ_ሩ
1_samuel=መጽሐፈ_ሳሙኤል_ቀዳማዊ=መጻ_ሳሙ_ቀደ
2_samuel=መጽሐፈ_ሳሙኤል_ካል=መጻ_ሳሙ_ካል
1_kings=መጽሐፈ_ነገሥት_ቀዳማዊ=መጻ_ነገ_ቀዳ
2_kings=መጽሐፈ_ነገሥት_ካልዕ=መጻ_ነገ_ካል
1_chronicles=መጽሐፈ_ዜና_መዋዕል_ቀዳማዊ=መጻ_ዜና_መዋ_ቀዳ
2_chronicles=መጽሐፈ_ዜና_መዋዕል_ካልዕ=መጻ_ዜና_መዋ_ካል
ezra=መጽሐፈ_ዕዝራ=መጻ_ዕዝ
nehemiah=መጽሐፈ_ነህምያ=መጻ_ነህ
esther=መጽሐፈ_አስቴር=መጻ_አስ
job=መጽሐፈ_ኢዮብ=መጻ_ኢዮ
psalms=መዝሙረ_ዳዊት=መዝ
proverbs=መጽሐፈ_ምሳሌ=መም
ecclesiastes=መጽሐፈ_መክብብ=መመ
song_of_solomon=መኃልይ_ዘሰሎሞን=መኃ_ዘሰ
isaiah=ትንቢተ_ኢሳይያስ=ት_ኢሳ
jeremiah=ትንቢተ_ኤርምያስ=ት_ኤር
lamentations=ሰቆቃው_ኤርምያስ=ሰቆ_ኤር
ezekiel=ትንቢተ_ሕዝቅኤል=ት_ሕዝ
daniel=ትንቢተ_ዳንኤል=ት_ዳን
hosea=ትንቢተ_ሆሴዕ=ት_ሆ
joel=ትንቢተ_ኢዮኤል=ት_ኢዮ
amos=ትንቢተ_አሞጽ=ት_አሞ
obadiah=ትንቢተ_አብድዩ=ት_አብ
jonah=ትንቢተ_ዮናስ=ት_ዮና
micah=ትንቢተ_ሚክያስ=ት_ማክ
nahum=ትንቢተ_ናሆም=ት_ናሆ
habakkuk=ትንቢተ_ዕንባቆም=ት_ዕን
zephaniah=ትንቢተ_ሶፎንያስ=ት_ሶፎ
haggai=ትንቢተ_ሐጌ=ት_ሕ
zechariah=ትንቢተ_ዘካርያስ=ት_ዘካ
malachi=ትንቢተ_ሚልክያ=ት_ሚል

matthew=የማቴዎስ_ወንጌል=የማ_ወን
mark=የማርቆስ_ወንጌል=የማር_ወን
luke=የሉቃስ_ወንጌል=የሉ_ወን
john=የዮሐንስ_ወንጌል=የዩ_ወን
acts=የሐዋርያት_ሥራ=የሐ_ሥ
romans=ወደ_ሮሜ_ሰዎች=ወ_ሮ_ስ
1_corinthians=1ኛ_ወደ_ቆሮንቶስ_ሰዎች=1ኛ_ወ_ቆ_ሰ
2_corinthians=2ኛ_ወደ_ቆሮንቶስ_ሰዎች=1ኛ_ወ_ቆ_ሰ
galatians=ወደ_ገላትያ_ሰዎች=ወ_ገላ_ሰ
ephesians=ወደ_ኤፌሶን_ሰዎች=ወ_ኤ_ሰዎ
philippians=ወደ_ፊልጵስዩስ_ሰዎች=ወ_ፊል_ሰዎ
colossians=ወደ_ቆላስይስ_ሰዎች=ወ_ቆላ_ሰ
1_thessalonians=1ኛ_ወደ_ተሰሎንቄ_ሰዎች=1ኛ_ወ_ተ_ሰ
2_thessalonians=2ኛ_ወደ_ተስሎንቄ_ሰዎች=2ኛ_ወ_ተ_ሰ
1_timothy=1ኛ_ወደ_ጢሞቴዎስ=1ኛ_ወ_ጤሞ
2_timothy= 2ኛ_ወደ_ጢሞቴዎስ=2ኛ_ወ_ጤሞ
titus=ወደ_ቲቶ=ቲ
philemon=ወደ_ፊልሞና=ወ_ፊሊ
hebrews=ወደ_ዕብራውያን=ወ_ዕብ
james=የያዕቆብ_መልእክት=የያ_መል
1_peter=1ኛ_የጴጥሮስ_መልእክት=1ኛ_የጼ_ሰ
2_peter=2ኛ_የጴጥሮስ_መልእክት=1ኛ_የጴ_ሰ
1_john=1ኛ_የዮሐንስ_መልእክት=1ኛ_የዮ_መል
2_john=2ኛ_የዮሐንስ_መልእክት=2ኛ_የዮ_መል
3_john=3ኛ_የዮሐንስ_መልእክት=3ኛ_የዮ_መል
jude=የይሁዳ_መልእክት=የዩ_መል
revelation=የዮሐንስ_ራእይ=የዩ_ራእ