enesis=ኦሪት_ዘፍጥረት
exodus=ኦሪት_ዘጸአት
leviticus=ኦሪት_ዘሌዋውያን
numbers=ኦሪት_ዘኍልቍ
deuteronomy=ኦሪት_ዘዳግም
joshua=መጽሐፈ_ኢያሱ_ወልደ_ነዌ
judges=መጽሐፈ_መሣፍንት
ruth=መጽሐፈ_ሩት
1_samuel=መጽሐፈ_ሳሙኤል_ቀዳማዊ
2_samuel=መጽሐፈ_ሳሙኤል_ካል
1_kings=መጽሐፈ_ነገሥት_ቀዳማዊ
2_kings=መጽሐፈ_ነገሥት_ካልዕ
1_chronicles=መጽሐፈ_ዜና_መዋዕል_ቀዳማዊ
2_chronicles=መጽሐፈ_ዜና_መዋዕል_ካልዕ
ezra=መጽሐፈ_ዕዝራ
nehemiah=መጽሐፈ_ነህምያ
esther=መጽሐፈ_አስቴር
job=መጽሐፈ_ኢዮብ
psalms=መዝሙረ_ዳዊት
proverbs=መጽሐፈ_ምሳሌ
ecclesiastes=መጽሐፈ_መክብብ
song_of_solomon=መኃልየ_መኃልይ_ዘሰሎሞን
isaiah=ትንቢተ_ኢሳይያስ
jeremiah=ትንቢተ_ኤርምያስ
lamentations=ሰቆቃው_ኤርምያስ
ezekiel=ትንቢተ_ሕዝቅኤል
daniel=ትንቢተ_ዳንኤል
hosea=ትንቢተ_ሆሴዕ
joel=ትንቢተ_ኢዮኤል
amos=ትንቢተ_አሞጽ
obadiah=ትንቢተ_አብድዩ
jonah=ትንቢተ_ዮናስ
micah=ትንቢተ_ሚክያስ
nahum=ትንቢተ_ናሆም
habakkuk=ትንቢተ_ዕንባቆም
zephaniah=ትንቢተ_ሶፎንያስ
haggai=ትንቢተ_ሐጌ
zechariah=ትንቢተ_ዘካርያስ
malachi=ትንቢተ_ሚልክያ

matthew=የማቴዎስ_ወንጌል
mark=የማርቆስ_ወንጌል
luke=የሉቃስ_ወንጌል
john=የዮሐንስ_ወንጌል
acts=የሐዋርያት_ሥራ
romans=ወደ_ሮሜ_ሰዎች
1_corinthians=1ኛ_ወደ_ቆሮንቶስ_ሰዎች
2_corinthians=2ኛ_ወደ_ቆሮንቶስ_ሰዎች
galatians=ወደ_ገላትያ_ሰዎች
ephesians=ወደ_ኤፌሶን_ሰዎች
philippians=ወደ_ፊልጵስዩስ_ሰዎች
colossians=ወደ_ቆላስይስ_ሰዎች
1_thessalonians=1ኛ_ወደ_ተሰሎንቄ_ሰዎች
2_thessalonians=2ኛ_ወደ_ጢሞቴዎስ
1_timothy=1ኛ_ወደ_ጢሞቴዎስ
2_timothy= 2ኛ_ወደ_ጢሞቴዎስ
titus=ወደ_ቲቶ
philemon=ወደ_ፊልሞና
hebrews=ወደ_ዕብራውያን
james=የያዕቆብ_መልእክት
1_peter=1ኛ_የጴጥሮስ_መልእክት
2_peter=2ኛ_የጴጥሮስ_መልእክት
1_john=1ኛ_የዮሐንስ_መልእክት
2_john=2ኛ_የዮሐንስ_መልእክት
3_john=3ኛ_የዮሐንስ_መልእክት
jude=የይሁዳ_መልእክት
revelation=የዮሐንስ_ራእይ